###############################
#A# #       #   #   #       # #
# # # # ##### # # # # ##### # #
# #     #     # # # #     #   #
# ##### # ##### ##### ##### # #
#     # #   # #     # #   #   #
# ### # ### # # ##### # ##### #
#   # #   #     # #   #       #
# ### ### ##### # # ##### #####
# #   #       # # #   #   #   #
# # # # ##### # ### # ### ### #
#     #   #   #   # #     #   #
##### ### # ####### ##### #####
#   #     #       #   # #     #
# # # ##### # # # # # # # #####
# # #     # # #   # # #   #   #
# ##### # ### ### # # ##### # #
#     #         #   #       #B#
###############################
